kor	wuu
ɑmitʰɑbul	omid̥v̩ʷv̥əʔ
ɛdʑʌŋ	e̞ʑ̥ɪɲ
ɛin	e̞n̠ʲɪɲ
tɕʌdʑʌ	t͡ɕiat͡ɕia
lɯŋ	lɪɲ
hoktɕ*ɑ	ɦʊʔt͡se̞
ɑndʑʌn	øʑ̥i
ɑndʑɑŋ	øt͡sɑ̃
ɑndʑʌŋ	ød̥ɪɲ
ɑndʑʌŋ	øʑ̥ɪɲ
ɑn	ø
hɛŋwa	ɦãho
hɛŋdʑɑ	ɦãt͡sz
hɛŋin	ɦãn̠ʲɪɲ
wi	ɦɯe̞
witɕʰi	ɦɯet͡sz
wijʌp	ɯe̞ɕi̯ɪʔ
ɰiɰi	in̠ʲi
ɰiɡjʌn	it͡ɕi
ɰisɑ	isz
jʌk	ɦi
wi	ɦɯe
wisɑn	ɦɯes
ɰi	i
ɰiɡɯm	it͡ɕɪɲ
ɰisɑŋ	iz̥ɑ̃
ɰibok	iv̥ʊʔ
juɡɑm	ɦiɦø
juboktɕ*ɑ	ɦifʊʔt͡sz̩
tɕʌŋ	t͡ɕɪɲ
hɛ	ɦe
il	i̯ɪʔ
iɾɑ	i̯ɪʔɦo
iɾwʌl	i̯ɪʔɦɥ̯ɪʔ
ilsɛɡjɛ	i̯ɪʔszka̱
iltɕʰʌn	i̯ɪʔt͡ɕʰi
ildʑik	i̯ɪʔz̥əʔ
iltɕʰʌn	i̯ɪʔtʰi
ildo	i̯ɪʔd̥ɔ
iɾil	i̯ɪʔn̠ʲi̯ɪʔ
ilbɑn	i̯ɪʔpø
ilbɑn	i̯ɪʔpe
iɾjaŋ	i̯ɪʔɦiã
ilmɑn	i̯ɪʔv̥e
ilbjʌn	i̯ɪʔpi
ildʑʌm	i̯ɪʔti
ildʑɛ	i̯ɪʔʑ̥i
in	ɪɲ
wʌn	ɦyø
in	ɪɲ
wʌn	ɦø
ɯm	ɪɲ
ɯmjʌŋ	ɪɲɪɲ
ɯmmo	ɪɲmɔ
ɯmjaŋ	ɪɲɦiã
un	ɦʏɲ
ummun	ɦʏɲv̥əɲ
u	ɦiɜ
usu	ɦiɜsɜ
umjʌn	ɦiɜmi
ubjʌn	ɦiɜpi
udʑu	ɦyz̥ɜ
odʑʌɡʌ	v̩ʷz̥əʔɦŋ̍
oɑ	v̩ʷia̱
u	ɦy
umo	ɦymɔ
usɑn	ɦyse
usu	ɦysz
udʑʌm	ɦyti
mjo	mɔ
tɕʰuk	t͡sʰɜ
uŋɡi	ɦʏɲt͡ɕʰi
jʌŋɑ	ɪɲɦəɻ
jʌŋ	i̯ʊŋ
jʌŋwʌn	i̯ʊŋɦyø
jʌŋʌ	ɪɲn̠ʲy
jʌŋmun	ɪɲv̥əɲ
jʌŋuŋ	ɪɲɦi̯ʊŋ
wi	ɦɯe
wisʌŋ	ɦɯeɕɪɲ
wisɛŋ	ɦɯesəɲ
ik	i̯ɪʔ
wʌllɑm	ɦɥ̯ɪʔnø
wʌn	ɦyø
wʌndʑʌŋ	ɦyøtɪɲ
jʌn	ɦi
jʌm	ɦi
jʌn	i
jʌntɕʰo	it͡sʰɔ
jʌndɛ	id̥e̞
jʌndʑɑ	it͡sz̩
wʌndʑok	ɦøt͡sʊʔ
jʌn	kʰe
jʌmpʰi	kʰeb̥i
jʌmpʰil	kʰepi̯ɪʔ
wʌnɑŋ	yøiã
waŋwaŋ	ɯɑ̃ɯɑ̃
waŋ	ɦɯɑ̃
waŋu	ɦɯɑ̃ɦɜ
waŋbʌp	ɦɯɑ̃fa̱ʔ
waŋɡuk	ɦɯɑ̃kʊʔ
ʌk	ɦi
ʌk	i
ɯl	i̯ɪʔ
ɯm	ɪɲ
ɯmɑk	ɪɲɦia̱ʔ
hɑsɑn	ɦose
hɑbɑnnjʌn	ɦopøn̠ʲi
hwasʌk	hoz̥a̱ʔ
hwanoŋ	honʊŋ
hwaɑk	hoɦia̱ʔ
kɑ	ka̱
kɑip	ka̱n̠ʲi̯ɪʔ
kɑ	kʰv̩ʷ
kɑnɯŋ	kʰv̩ʷnəɲ
hɑdʑi	ɦot͡sz̩
kɑdʑu	ka̱t͡sz̩
kɑin	t͡ɕia̱z̥əɲ
kɑdʑok	t͡ɕia̱z̥ʊʔ
kɑdʑʌŋ	t͡ɕia̱d̥ɪɲ
kwabu	kɯa̱v̥v̩ʷ
kwa	kʰv̩ʷ
kwaɑk	kʰv̩ʷɦia̱ʔ
kwajʌn	kv̩ʷz̥ø
kɑsu	kv̩ʷsɜ
hɑmɑ	ɦv̩ʷmo
hɑɾju	ɦv̩ʷliɜ
hwa	hv̩ʷ
hwasɑn	hv̩ʷse̞
hwatɕʰɑ	hv̩ʷt͡sʰo
hwasʌŋ	hv̩ʷɕɪɲ
hwadʑɑŋdʑɑŋ	hv̩ʷt͡sɑ̃z̥ã
hwaɾo	hv̩ʷlv̩ʷ
hwajak	hv̩ʷɦia̱ʔ
hwawʌn	hoɦyø
hwaɡɑp	hot͡ɕia̱ʔ
hwadʑɑŋ	hoz̥iã
hwasim	hoɕɪɲ
hwadʑo	hoʔn̠ʲɔ
hwabun	hofəɲ
hwaɾju	holiɜ
hwaɾosu	holv̩ʷsz̩
hwatɕʰo	hot͡ɕiɔ
hwapʰɑn	hob̥e̞
kɑdʑɑ	ɡ̊a̱t͡sz̩
hɑwa	ɦv̩ʷho
hwaɡjo	ɦod̥͡ʑiɔ
kwa	kʰv̩ʷ
hwasɛk	hv̩ʷsəʔ
hwapʰɛ	hv̩ʷb̥i
kwadʑʌl	kv̩ʷt͡ɕi̯ɪʔ
ɑʌ	ŋv̩ʷn̠ʲy
ɑɾɑsɑ	ŋv̩ʷlv̩ʷsz̩
ɑdʑɑ	ŋa̱t͡sz
ɑtɕʰi	ŋa̱t͡sʰz
hɛ	ɡ̊a̱
hɛbɑŋ	t͡ɕia̱fɑ̃
hɛbɑŋɡun	t͡ɕia̱fɑ̃t͡ɕʏɲ
hwɛ	ɦɯe
hwɛdɑp	ɦɯeta̱ʔ
hwɛɾo	ɦɯelv̩ʷ
kwɛ	kʰɯe
kʰwɛ	kʰɯa̱
kʰwɛɾɑk	kʰɯa̱lʊʔ
hɛwaŋsʌŋ	heɦɯɑ̃ɕɪɲ
hɛwɛ	heŋa̱
hɛɡu	hekʰɜ
hɛsu	hesz
hɛdon	hed̥əɲ
hɛpʰjo	hzpɔ
hɛjaŋ	heɦiã
hɛdɛ	heta̱
hwɛ	hɯe
hwɛsɛk	hɯesəʔ
hwɛdʑin	hɯez̥əɲ
kɛɡwan	kʰekv̩ʷø
kɛsi	kʰesz
kɛsi	kʰez̥z
kɛsim	kʰe̞sɪɲ
kɛboŋ	kʰefʊŋ
wɛ	ŋa̱
wɛsɛŋ	ŋa̱sã
wɛdʑobu	ŋa̱t͡sv̩ʷv̥v̩ʷ
wɛdʑomo	ŋa̱t͡sv̩ʷmv̩ʷ
wɛdʑi	ŋa̱d̥i
wɛmjʌn	ŋa̱mi
wɛɡuk	ŋa̱kʊʔ
wɛɡuɡin	ŋa̱kʊʔn̠ʲɪɲ
hɛso	kʰəʔsɜ
hɛsu	kʰəʔsɜ
hɛ	ɦe
kɛ	ke
kɑdo	ka̱d̥ɔ
kɑk	kʊʔ
kjʌk	ka̱ʔ
kɑk	kʊʔ
kɑk	kʊʔ
kjʌk	ka̱ʔ
hjʌŋmjʌŋ	kəʔmɪɲ
ɑkp*u	ŋʊʔv̥v̩ʷ
ɛk	ŋa̱ʔ
lip	li̯ɪʔ
hɑl	kəʔ
hɑl	həʔ
hwaldoŋ	ɦɯə̯ʔd̥ʊŋ
kolɡjɛ	ɦɯa̱ʔt͡ɕi
tɕuk	t͡sʊʔ
wado	ŋotɔ
kʌn	d̥͡ʑi
kʌndʑʌndʑi	kød̥iz̥z̩
kwan	kv̩ʷø
kwansɑ	kv̩ʷøz̥z̩
hɑllo	ɦølv̩ʷ
wandʑʌn	ɦv̩ʷøʑ̥i
kwan	kv̩ʷø
kɑn	kø
kɑnsʌn	køɕi
kɑmbu	køb̥v̩ʷ
kɑm	kø
kɑmɯn	køəɲ